11111111111111
110C000000C011
11C10CE0C01011
110P1011100011
11111111111111