111111
1P0001
11C1E1
111C11
111111
