1111111111111111
1PCCCCCCC1001111
1000000000E00001
1000000000000111
10000000010001C1
1111111111111111
