1111111111111
1P0100001E1C1
1000011111001
1000110001011
1111111111111
