1111111111111
1P0100000E0C1
1000011111001
1000110001011
1111111111111
